________
________
_*&@____
____@*__
_*__@___
____*___
_@__@@*_
____*___
________