  ##### 
###   # 
#     # 
###   # 
# ##  # 
# #   ##
#      #
#      #
########