##########
#        #
# # ## # #
#        #
# # ## # #
# # ## # #
# # ## # #
#        #
# # ## # #
#        #
##########