__________
_&________
__________
___**_*___
__________
__________
__________
__@_@__@__
__________
__________
__________